+-+-+-+-+
|I  |   |
+-+ +-+-+
| |   | |
+ + + +-+
| | | | |
+-+ + +-+
|      O|
+-+-+-+-+
