+-+-+-+-+-+-+-+-+
|I| |     |     |
+ +-+ + + + +-+ +
|     | |     | |
+-+ +-+ +-+ + + +
| | | |       | |
+ + +-+-+-+ + + +
| |     |   |  O|
+-+-+-+-+-+-+-+-+
