+-+-+-+-+-+-+-+-+-+-+-+-+-+-+-+-+-+-+-+-+-+-+
|I                                          |
+ +-+-+-+-+-+-+-+-+-+-+-+-+-+-+-+-+-+-+-+-+ +
| |                                         |
+ + +-+-+-+-+-+-+-+-+-+-+-+-+-+-+-+-+-+-+-+-+
| |                                         |
+ +-+-+-+-+-+-+-+-+-+-+-+-+-+-+-+-+-+-+-+-+ +
| |                                         |
+ + +-+-+-+-+-+-+-+-+-+-+-+-+-+-+-+-+-+-+-+-+
| |                                         |
+ +-+-+-+-+-+-+-+-+-+-+-+-+-+-+-+-+-+-+-+-+ +
| |                                         |
+ +-+-+-+-+-+-+-+-+-+-+-+-+-+-+-+-+-+-+-+-+ +
|                                          O|
+-+-+-+-+-+-+-+-+-+-+-+-+-+-+-+-+-+-+-+-+-+-+
